1111111111111
100100C00E0C1
10C0011111001
1P0011E00CE01
1111111111111