1111111111111111111111111111111111111
10000C0001C000010000000000000C0000001
1001110001111001000010000001000111101
1P01010001C0000100C01000000100000E1C1
1001110001111101111111110001000111101
1000000100000000000C00000000000000001
1111111111111111111111111111111111111