1111111111111
101C10000C001
1010111111001
1P000001E0001
1111111111111