1111111111111
101C10000C001
1010101111001
1P000001E0001
1111111111111